# Resources from graph.properties
alreadyConnected=节点已连接
cancel=取消
close=关闭
collapse-expand=折叠/展开
containsValidationErrors=包含验证错误
done=完成
doubleClickOrientation=双击可更改方向
error=错误
errorSavingFile=保存文件时出错
ok=同意
updatingDocument=正在更新文档。请稍候。。。
updatingSelection=正在更新选择。请稍候。。。
# Custom resources
about=关于
actualSize=实际尺寸
add=增加
addLayer=添加层
addProperty=添加属性
addToExistingDrawing=添加到现有图形
addWaypoint=添加路线点
advanced=高级
align=排列
alignment=对齐
allChangesLost=所有更改都将丢失！
angle=角度
apply=应用
arc=弧形
arrange=排列
arrow=箭头
arrows=箭头集
automatic=自动
autosave=自动保存
autosize=自动调整大小
back=后退
background=背景
backgroundColor=背景色
backgroundImage=背景图片
basic=基础
block=块
blockquote=块引用
bold=粗体
border=边界
borderWidth=边界宽度
borderColor=边界颜色
bottom=底部
bottomAlign=底部对齐
bottomLeft=左下角
bottomRight=右下角
bulletedList=符号列表
cannotOpenFile=无法打开文件
center=水平居中
change=改变
changeOrientation=改变方向
circle=圆角
classic=经典
clearDefaultStyle=恢复默认样式
clearWaypoints=清除路线点
clipart=剪贴画
collapse=折叠
collapseExpand=折叠/展开
collapsible=可折叠
comic=褶皱
connect=连接
connection=关联
connectionPoints=辅助操作点(生成连线)
connectionArrows=辅助箭头(复制图形、生成连线)
constrainProportions=约束比例
copy=复制
copyConnect=连接时复制
copySize=复制大小
create=创建
curved=弧形
custom=自定义
cut=剪切
dashed=虚线
decreaseIndent=减少缩进
default=默认
delete=删除
deleteColumn=删除列
deleteRow=删除行
diagram=参数设置
diamond=菱形
diamondThin=菱形 (细)
direction=方向
distribute=分配
divider=分隔符
documentProperties=文档属性
dotted=点划线
dpi=DPI
drawing=绘图{1}
drawingEmpty=图纸为空
drawingTooLarge=图纸太大
duplicate=创建副本
duplicateIt=副本 {1}
east=东
edit=编辑
editData=编辑数据
editDiagram=编辑关系图
editImage=编辑图像
editLink=编辑链接
editStyle=编辑样式
editTooltip=编辑工具
enterGroup=进入组
enterValue=输入值
enterName=输入名称
enterPropertyName=输入属性名称
entityRelation=实体关系
exitGroup=退出组
expand=展开
export=输出
extras=扩展
file=文件
fileNotFound=找不到文件
filename=文件名
fill=填充
fillColor=填充颜色
fitPage=单页
fitPageWidth=页宽自适应
fitTwoPages=双页
fitWindow=图形自适应
flip=翻转
flipH=水平翻转
flipV=垂直翻转
font=字体
fontFamily=字体集
fontColor=字体颜色
fontSize=字体大小
format=格式
formatPanel=参数面板
general=常规
formatPdf=PDF
formatPng=PNG
formatGif=GIF
formatJpg=JPEG
formatSvg=SVG
formatXml=XML
formatted=格式化
formattedText=格式化文本
gap=间隔
glass=渐变
global=全局
gradient=渐变
gradientColor=颜色
grid=网格
gridSize=网格大小
group=创建组
guides=指引
heading=标题
height=高
help=帮助
hide=隐藏
hideIt=隐藏 {1}
hidden=遮挡
home=主页
horizontal=水平
horizontalFlow=水平流动
horizontalTree=水平树
html=HTML
id=ID
image=图片
images=图片集合
import=导入
increaseIndent=增加缩进
insert=插入
insertColumnBefore=向左插入列
insertColumnAfter=向右插入列
insertHorizontalRule=插入分割线
insertImage=插入图片
insertLink=插入链接
insertRowBefore=在上面插入行
insertRowAfter=在下面插入行
invalidInput=无效输入
invalidName=无效名称
invalidOrMissingFile=文件无效或丢失
isometric=等距
italic=斜体
layers=图层
landscape=风景
laneColor=蓝绿色
layout=布局
left=左
leftAlign=左对齐
leftToRight=从左到右
line=线
link=链接
lineJumps=相交线
lineend=线尾
lineheight=线高
linestart=线首
linewidth=线宽
loading=加载中
lockUnlock=加锁/解锁
manual=手动
middle=垂直居中
misc=杂项
more=更多
moreResults=更多结果
move=移动
moveSelectionTo=将所选内容移动到 {1}
navigation=导航
new=新建
noColor=无颜色
noFiles=无文件
noMoreResults=无更多结果
none=无
noResultsFor=没有结果 '{1}'
normal=正常
north=北
numberedList=编号列表
opacity=不透明度
open=打开流程图
openArrow=打开箭头
openFile=打开文件
openLink=打开链接
openSupported=支持的格式是从该软件保存的.XML文件
openInNewWindow=在新窗口中打开
openInThisWindow=在当前窗口中打开
options=选项
organic=间距
orthogonal=直角
outline=缩略图
oval=椭圆形
pages=页
pageView=页面视图
pageScale=页面比例
pageSetup=页面设置
panTooltip=空格+拖动 可滚动
paperSize=纸张大小
paste=粘贴
pasteHere=粘贴到此处
pasteSize=粘贴大小
pattern=模式
perimeter=周长
placeholders=占位符
plusTooltip=单击以连接并克隆（按住ctrl键并单击以克隆，按住shift键并单击以连接）。拖动以连接（按住ctrl键并拖动以克隆）。
portrait=描绘
position=位置
posterPrint=海报打印
preview=预览
print=打印
radialTree=子午线树
redo=重做
removeFormat=清除格式
removeFromGroup=从组中删除
removeIt=删除 {1}
removeWaypoint=删除路线点
rename=重命名
renameIt=重命名 {1}
replace=替换
replaceIt={1} 已经存在。要替换它吗？
replaceExistingDrawing=替换现有图形
reset=重置
resetView=重置视图
reverse=反转
right=右
rightAlign=右对齐
rightToLeft=从右向左
rotate=旋转
rotateTooltip=单击并拖动可旋转，单击可将形状仅旋转90度
rotation=旋转一周
rounded=圆形
save=保存
saveEdit=保存(修改基本信息)
saveAs=另存为
saved=保存的
scrollbars=滚动条
search=搜索
searchShapes=搜索形状
selectAll=全选
selectEdges=选择边
selectFont=选择字体
selectNone=取消选择
selectVertices=选择顶点
setAsDefaultStyle=设置为默认样式
shadow=阴影
shape=形状
sharp=锐利的
sidebarTooltip=单击展开。将形状拖放到关系图中。按住Shift键并单击可更改选择。按住Alt键并单击可插入和连接。
simple=简单
simpleArrow=简单箭头
size=尺寸
solid=实心
sourceSpacing=源间距
south=南
spacing=文本间距
straight=笔直地
strikethrough=删除线
strokeColor=线条颜色
style=风格
subscript=下标
superscript=上标
table=表格
targetSpacing=目标间距
text=文本
textAlignment=文本对齐方式
textOpacity=文本不透明度
toBack=向下
toFront=向上
tooltips=工具提示
top=顶部
topAlign=顶部对齐
topLeft=顶部左
topRight=顶部右
transparent=透明
turn=只旋转90度
uml=UML
underline=下划线
undo=撤消
ungroup=取消组
url=URL
untitledLayer=无标题图层
vertical=垂直
verticalFlow=垂直流
verticalTree=垂直树
view=参数面板
waypoints=路线点
west=西
width=宽
wordWrap=自动换行
writingDirection=书写方向
zoom=缩放
zoomIn=放大
zoomOut=缩小
flowchart=流程图
basicFlow=常规流程图
exam=模拟运行
script=脚本列表
share=共享空间
submit=提交
workTime=模拟工期
#自适应设计模型
model=模型
openModel=打开模型
stepCount=分步计算
modelData=数据
modelDataOpen=打开
modelDataSave=保存
modelDataSaveEdit=编辑保存
modelDataSaveAs=另存为
#课程模型
courseData=数据
courseDataNew=重新加载
courseDataOpen=打开
courseDataSave=保存
courseDataSaveEdit=编辑保存
courseDataSaveAs=另存为